1111111111111111111111111111111111111111
1011CP000C1100000C0C00C0010C111000100001
100000001C100000010110C00C10100C11010001
10C0000000001000CC00011C00010100CC001111
1C1000C000C00100C0001001000C0010C0000C01
11000C010000100011C001100C1C1100110C0C01
10C0000C000001000C1000100000000000000001
1111000CC0110C00C00001000000CCCC0C000011
1000C00C0C00C0C00000000100010010000C0001
1010000000000C0010C011000000CCC000100001
100010C100C11100C00011CC0CCC00000C00C011
100CCC00001CC0C101000C1101000C1000C00C01
10110C00000C0C011CCC0001C010100001CC0101
1000000CC00100110000C0C00001001000000001
10000CCC00000000000C0C000C00010000000001
1000100C010C00000010000100C1000001000001
100000C000C1000010C0CCCC0110000C00010001
1C0C10000000C0C00000000001C00C0C00000001
1C0010001000010C00010C00C0C01000000C0101
10CCC00000000100C00001C1C0C0000001000011
10CCC0C0C00000C00111C00010100CC111001101
11C00C010C0010C00101C0000100000C01110CC1
10C000111C000100010100000EC00C00100C0101
1CC0C0000001000C000001100100C00000101001
1111111111111111111111111111111111111111
