11111111111111111111111111111111111111111111111111
1CCC0110C00C00C000C1000C1000C01P1000010C00010EC011
1CC11C100110C1C0CC001000C10001110C00CC010000C010C1
1C01C0001C000CC010C101010C100CC111001001001CC001C1
11111111111111111111111111111111111111111111111111
