1111111111111111111111111111111111111111
100111C0000101CC00111111CC0C0C00C10C0C11
10CC010CC010CC010C000C0000C0C00101CP0001
10100001CC000001CE1001011CCC1C0100C00001
1111111111111111111111111111111111111111
