11111111111111111111
10010C0C1C0011000001
1C10001C000010C00101
101111010P0C0C00C1C1
10C000CC01000C0C0011
10C01C00C0010001C001
1110C000E0000C00C101
1000000100101001C1C1
1C1C01000C000CC00001
11111111111111111111
